.#.#.#.#.#.
#.#.#.#.#.#
#....@....#
#.........#
####...####
#.........#
###.#.#.###
#####.#####
#.........#
##.......##
###########
